331LR1L3333333R
313333333333R35
333333333333335
333333333333335
7633*1l33333r15
331333333333335
333l33333333331