II1LR1LIIIIIIIR
I1IIIIIIIIIIRI#
IIIIIIIIIIIIII#
IIIIIIIIIIIIII#
@=II*1lIIIIIr1#
II1IIIIIIIIIII#
IIIlIIIIIIIIII1