  11111 11111  
  1   111   1  
  1 # 1@1 # 1  
11111A1=1A11111
1 b C     D b 1
1 # 1c ? d1 # 1
11111# * #11111
1 # 1c   d1 # 1
1   D  #  C   1
111111B1B111111
    1  1  1    
    1 #1# 1    
    1  1a 1    
    1111111    